{
  "background": "black",
  "wall": "wall.png",
  "tile_size": 50,
  "start_position": [100, 100],
  "grid": [
    [1, 1, 1, 1, 1, 1, 1, 1],
    [1, 0, 0, 0, 0, 0, 0, 1],
    [1, 0, 2, 2, 2, 2, 0, 1],
    [1, 0, 2, 0, 0, 2, 0, 1],
    [1, 0, 2, 0, 0, 2, 0, 1],
    [1, 0, 0, 0, 0, 0, 0, 1],
    [1, 1, 1, 1, 1, 1, 1, 1]
  ]
}